11111111111111111
10001000000001C01
1001P000000001101
1000100000001E001
10000000000001001
1000C00C000000001
100000000000000C1
10001000000001C01
10010000000001101
10001000000010001
10000000000001001
1000C00C000000001
100000000000000C1
10001000000001C01
10010000000001101
10001000000010001
10000000000001001
1000C00C000000001
100000000000000C1
10000000000001001
1000C00C000000001
100000000000000C1
10001000000001C01
10010000000001101
10001000000010001
10000000000001001
1000C00C000000001
100000000000000C1
10000000000001001
1000C00C000000001
100000000000000C1
10001000000001C01
10010000000001101
10001000000010001
10000000000001001
1000C00C000000001
100000000000000C1
11111111111111111

