11111111111111111
10001000000001001
10010000000011101
1000100000001E001
10000000000000001
10000C00000000001
10000000000000001
10001000000010001
11111111111111111