11111111111111111
10001000000001001
1001P000000001101
1000100000001E001
1000000000000C001
10000000000000001
10000000000000001
10001000000001001
10010000000001101
10001000000010001
11111111111111111