11111111111111111
10001000000001001
1001P000000111001
100011000001E0001
100001C1000001001
11111111111111111