11111111111111111
10000000000000001
1000P000000000001
1000000000000E001
10000000000000001
1000C000000000001
1000000000P000001
11111111111111111
