11111111111111111
10001000000000C01
1001P000000001001
1000100000001E001
10000000000001001
1000C000000000001
100000000000000C1
11111111111111111
